insert into category (id, name) values (4,	'Ordina');
insert into category (id, name) values (5,	'namen');
insert into category (id, name) values (6,	'tijd');
insert into category (id, name) values (7,	'multiple choice');
insert into category (id, name) values (8,	'\N');
insert into category (id, name) values (9,	'huh');
insert into category (id, name) values (10,	'test');
insert into category (id, name) values (11,	'cola');
insert into category (id, name) values (2,	'kerst');
insert into category (id, name) values (3,	'domme vragen');
insert into category (id, name) values (12,	'Film & Televisie');
insert into category (id, name) values (13,	'Natuur');
insert into category (id, name) values (14,	'Muziek');
insert into category (id, name) values (15,	'Topografische Slang');
insert into category (id, name) values (16,	'Sport');
insert into category (id, name) values (17,	'Geluidsfragmenten');
insert into category (id, name) values (18,	'Eten & Drinken');
insert into category (id, name) values (19,	'Reserve');
insert into category (id, name) values (20,	'Logos');
insert into category (id, name) values (21,	'Algemene kennis');
insert into category (id, name) values (22,	'algemeen');
insert into category (id, name) values (23,	'Algemeen');